11111111111111111111111111111111
1..............................1
1..............................1
11111111111111111111111111111111
1..............................1
1..2.......2...............2...1
1................3.............1
111111...M................111111
1..............................1
1..2...........M.....H.........1
1..............................1
111111....................111111
1..........2...................1
1...H.............M.........2..1
1...........3..........2.......1
111111....................111111
1...................M..........1
1...2......M..............H....1
1..............................1
111111....H.....2.........111111
1..............................1
1.2......M............P....444.1
1..............................1
11111111111111111111111111111111